0000000000
0010100000
0011000000
0001000000
0000000000
0000000000
0000000000
0000000000
0000000000
